###                 #########
#   ###################   # #
# ####                # # # #
# ################### # # # #
#                     # # # #
# ################### # # # #
#   ##                # # # #
# # ## ### ## ######### # # #
# #    #   ## #         # # #
#B# ## ################ # # #
### ##             #### # # #
### ############## ## # # # #
###             ##    # # # #
###### ######## ####### # # #
###### ####             #   #
A      ######################
